%%%%%%%%%%%%%%%%%%%%%%%%
%135    F      o    246%
%%%%%%%%%%%%%%%%%%%%%%%%