%%%%%%%%%%%%
%..o    642%
%F     %%%%%
%%%%%     F%
%135    o..%
%%%%%%%%%%%%